 [
   [363,363,363,363,363,363,363,363,363,363,363,363,95,201,201,201,201,201,201,201,201,201,201,201,201,201,95,363,363,363,363,363,363,363,363,363,363,363,363,363,363,363,363,363,363,363,363,363,363,363,363,363,363,363,363,363,363,363,363,363,363,363,363,95,201,201,201,201,145,201,201,201,201,201,201,201,201,201,201,201,201,201,201,201,201,201,201,201,97,285,285,285,285,285,285,285,285,285,285,285],
   [393,393,393,393,393,393,393,393,393,393,393,393,95,201,53,201,201,201,201,201,201,201,201,201,143,201,95,393,393,393,393,393,393,393,393,393,393,393,393,393,393,393,393,393,393,393,393,393,393,393,393,393,410,393,393,393,393,393,393,393,393,393,393,95,201,145,201,201,201,201,201,201,201,201,201,201,201,201,201,201,201,201,201,201,201,201,201,201,95,308,308,308,308,308,308,308,308,308,308,308],
   [393,393,410,393,393,393,393,393,393,393,97,97,95,201,201,201,201,201,201,201,201,201,201,201,201,201,95,393,393,393,393,393,410,393,393,393,393,393,393,393,393,393,393,393,393,393,393,393,393,393,393,393,393,393,393,393,393,393,393,393,393,393,393,95,201,201,201,201,201,201,201,201,201,201,201,201,201,201,201,201,201,201,201,201,201,201,201,201,95,331,331,331,331,331,331,331,331,331,331,331],
   [393,393,393,410,393,393,393,393,393,446,447,448,95,201,201,201,201,201,145,201,201,201,49,201,201,201,99,393,393,393,393,393,393,393,393,393,393,393,393,393,393,393,393,393,393,393,410,393,393,393,393,393,393,393,393,393,393,393,393,393,393,97,97,57,201,201,201,201,201,201,201,201,201,201,201,201,201,201,201,201,201,201,201,201,201,201,201,201,95,393,393,393,393,393,393,393,412,412,0,393],
   [393,393,393,393,393,393,393,393,393,469,470,471,95,201,201,201,201,201,201,201,201,201,201,201,201,201,95,450,451,452,393,393,393,393,393,393,393,393,393,393,393,393,393,393,393,393,393,393,393,393,393,393,393,393,393,393,393,393,393,393,393,393,393,95,201,201,201,201,201,201,201,201,201,201,201,201,201,201,201,201,201,201,201,201,201,201,201,201,95,393,393,393,393,393,393,393,393,412,0,393],
   [450,451,452,393,393,393,393,410,393,393,97,97,95,201,201,201,201,201,201,201,201,201,201,201,201,201,95,97,97,475,393,393,393,393,393,393,393,393,393,393,393,393,393,393,393,393,393,393,393,393,393,393,393,393,393,393,393,393,393,393,393,393,393,95,201,201,201,145,201,201,201,95,95,283,95,95,95,283,95,95,201,201,201,201,201,201,201,201,95,393,393,393,393,393,393,393,393,412,0,393],
   [473,474,475,393,393,393,393,393,393,412,393,393,57,201,201,201,201,201,201,201,201,201,201,201,201,201,99,393,393,393,393,393,393,393,393,393,393,393,393,393,393,393,393,393,393,393,393,393,393,393,393,393,393,393,393,393,393,393,393,393,393,393,393,95,201,201,201,201,201,201,201,95,393,306,393,393,393,306,393,95,201,201,201,201,201,201,201,201,95,393,393,393,393,393,393,393,393,412,0,393],
   [47,93,93,93,93,47,393,393,393,393,393,393,95,201,201,201,201,201,201,201,201,201,201,201,201,201,95,97,97,393,393,393,393,393,363,393,97,97,97,97,97,97,97,97,97,97,97,97,97,97,97,97,283,97,97,97,393,393,393,393,393,97,97,57,201,201,201,201,201,201,201,95,393,393,393,393,393,393,393,95,201,201,201,201,201,201,201,201,95,393,393,393,393,393,393,393,393,412,0,393],
   [438,438,201,201,201,93,393,410,410,393,393,393,97,95,95,95,95,95,95,95,95,95,95,95,95,95,97,393,393,393,393,393,393,393,97,97,97,393,393,393,393,393,393,393,393,393,393,393,393,393,393,393,306,393,393,97,393,393,393,393,393,393,393,97,95,95,95,95,95,95,95,95,393,393,393,393,393,393,393,95,95,95,95,95,95,95,95,95,97,393,393,393,393,393,393,393,393,412,0,393],
   [438,438,201,201,201,47,393,393,393,393,393,393,393,393,393,393,393,393,393,393,393,393,393,393,393,393,393,393,393,393,393,393,393,393,393,393,97,393,393,393,393,393,393,393,393,393,393,393,393,393,393,393,393,393,393,53,51,51,393,393,393,393,393,393,393,393,393,393,214,393,393,393,393,393,0,393,393,393,393,393,214,393,393,393,393,393,393,393,393,393,393,393,393,393,393,393,393,412,0,393],
   [201,201,201,201,201,47,97,97,393,393,393,393,393,393,393,393,393,393,393,393,410,393,393,393,393,393,393,393,393,393,393,393,393,393,393,393,57,393,393,393,393,393,393,393,393,393,393,393,393,393,393,393,393,393,393,97,393,393,393,393,393,393,393,393,393,393,393,393,214,393,393,393,393,0,0,97,393,393,393,393,214,393,393,393,393,393,393,393,393,393,393,393,393,393,393,410,393,412,412,393],
   [201,201,201,201,201,93,393,393,393,393,393,393,393,393,393,393,393,393,393,393,393,393,393,393,393,393,393,393,393,393,410,393,393,393,97,97,97,393,393,393,393,393,393,393,393,393,393,393,393,393,97,283,283,283,97,97,51,51,393,393,410,393,393,393,393,393,393,393,214,393,393,393,412,412,97,97,97,393,393,393,214,393,393,393,393,393,393,393,393,393,393,393,393,393,393,393,393,412,412,393],
   [201,143,201,201,201,99,393,393,393,393,393,393,393,410,393,393,393,393,393,393,393,393,393,393,393,393,393,393,393,393,393,393,393,393,393,393,97,393,393,393,393,393,393,393,393,393,393,393,393,393,97,306,306,306,393,393,393,393,393,393,393,393,393,393,393,393,393,393,214,393,72,393,412,97,97,97,97,97,393,393,214,393,393,393,393,393,393,393,393,393,393,393,393,393,393,393,393,412,412,393],
   [201,201,201,201,201,93,393,393,393,393,393,393,393,393,393,393,393,393,393,393,393,393,393,393,393,393,393,393,393,393,393,393,393,393,393,393,57,393,393,393,393,393,393,393,393,393,393,393,393,393,97,393,393,393,393,393,393,393,393,393,393,393,393,393,393,393,393,410,214,410,393,393,393,393,97,97,97,393,393,393,214,393,393,393,393,393,393,393,393,446,393,393,393,393,393,393,393,412,0,393],
   [201,49,201,201,201,93,97,97,393,393,393,393,393,393,393,393,393,393,393,393,393,393,393,393,393,393,393,393,393,393,393,393,393,393,97,97,97,97,97,97,97,97,97,97,97,97,97,393,393,393,97,97,97,97,97,97,393,393,393,393,393,393,393,393,393,393,393,393,214,393,393,393,393,393,393,97,393,393,393,393,214,393,393,393,393,393,393,393,393,393,393,393,393,393,393,393,393,412,0,393],
   [49,201,201,201,201,93,393,393,393,393,393,393,410,410,393,393,393,393,393,393,410,410,393,393,393,393,393,410,410,393,393,393,393,393,408,393,97,393,393,393,393,393,393,393,393,393,393,393,393,393,393,393,393,393,393,97,97,97,393,393,393,393,393,393,393,393,393,393,214,393,393,393,393,393,393,393,393,393,393,393,214,393,393,393,393,393,393,393,393,393,393,393,393,393,393,393,393,412,51,51],
   [201,201,201,201,201,47,393,393,393,393,393,393,410,410,393,393,393,393,393,393,410,410,393,393,393,393,393,410,410,393,393,393,393,393,393,393,97,393,393,393,393,393,393,393,393,393,393,393,393,393,393,393,393,393,393,53,393,393,393,393,393,393,393,393,393,393,393,393,214,393,393,393,393,393,393,393,393,393,393,393,214,393,393,393,393,393,410,393,393,393,393,393,393,393,393,393,393,412,0,393],
   [201,145,201,201,201,99,97,97,393,393,393,393,393,393,393,393,359,360,393,393,393,393,393,393,359,360,393,393,393,393,393,393,393,393,97,97,57,393,393,393,393,393,393,393,393,393,393,393,393,51,97,97,393,393,393,97,393,393,393,393,393,393,393,393,393,393,393,393,214,393,393,393,393,393,393,393,393,393,393,393,214,393,393,393,393,393,393,393,393,393,393,393,393,393,393,393,393,412,0,393],
   [201,201,201,201,201,97,450,451,452,393,393,393,393,393,393,393,382,383,393,393,393,393,393,393,382,383,393,393,393,393,393,393,393,446,447,448,97,393,393,393,393,393,393,393,97,393,393,393,393,393,393,393,393,393,393,53,97,97,393,393,393,393,393,393,393,393,393,393,214,393,393,393,393,393,393,393,393,393,393,393,214,393,393,393,393,393,393,393,393,393,393,393,393,393,393,393,393,412,0,393],
   [49,49,201,201,201,97,473,474,475,393,393,393,393,393,393,393,405,406,393,393,393,393,393,393,405,406,393,393,393,393,393,393,393,469,470,471,97,393,393,393,393,393,393,51,393,393,393,393,393,393,393,393,393,393,393,97,393,393,393,393,393,393,393,393,393,393,393,393,214,393,393,393,393,393,393,393,393,393,393,393,214,393,393,393,393,393,393,393,393,393,393,393,393,393,393,393,393,412,0,393],
   [49,49,49,49,49,97,97,97,412,412,412,97,97,97,97,97,97,97,97,97,97,97,97,97,97,97,97,97,97,97,97,97,97,97,97,97,97,393,393,393,393,393,393,393,393,393,393,393,393,393,393,393,393,393,393,97,97,97,97,97,97,97,97,97,97,97,97,97,97,97,97,97,97,97,97,97,97,97,97,97,97,97,97,97,51,51,51,51,51,393,393,393,393,393,393,393,51,51,51,51],
   [49,49,49,49,49,49,49,95,393,393,393,95,438,438,201,201,201,201,201,201,201,201,201,201,201,201,201,201,201,201,201,201,201,201,145,201,95,393,393,393,393,393,393,393,393,393,393,393,393,393,393,393,393,393,393,51,49,49,49,49,49,49,49,49,49,49,49,49,49,49,49,49,49,49,49,49,49,49,49,49,49,49,49,49,49,49,49,49,53,97,393,393,393,393,393,393,51,438,438,438],
   [49,49,49,49,49,145,49,53,97,393,393,95,438,201,201,201,201,201,201,145,201,201,201,201,201,201,201,201,201,201,201,201,201,201,201,201,95,393,393,393,393,393,393,393,393,393,393,393,393,393,393,393,393,393,393,51,49,49,49,145,49,49,49,49,49,49,49,145,49,49,49,49,49,49,49,49,49,49,49,49,49,49,49,49,49,49,49,49,51,393,393,393,393,393,393,393,51,438,438,438],
   [49,49,145,49,49,49,49,51,393,393,393,95,201,201,145,201,201,201,201,201,201,201,201,201,201,201,201,201,201,201,201,201,145,201,440,441,95,393,393,393,97,393,393,393,393,393,393,393,393,393,393,393,393,393,393,209,49,49,49,49,49,49,49,49,49,49,49,49,49,49,49,49,49,49,49,49,49,49,49,49,49,49,49,49,49,49,49,211,97,393,393,393,393,393,393,97,57,49,49,49],
   [49,49,49,49,49,49,49,51,393,393,393,95,201,201,201,201,201,201,201,201,201,201,201,201,201,201,201,201,201,201,201,201,201,201,463,464,95,393,393,393,393,393,393,393,393,393,393,393,393,393,393,393,393,393,393,97,209,49,49,49,49,49,49,49,49,49,49,49,49,49,49,49,49,49,49,49,49,49,49,49,49,49,49,49,49,49,211,97,53,393,393,393,393,393,393,393,51,49,49,49],
   [49,49,49,49,49,49,211,97,393,393,97,57,95,95,285,95,95,95,95,95,95,285,95,95,95,95,95,285,95,95,95,95,95,95,95,95,285,393,393,393,393,393,393,393,393,393,97,393,393,393,393,393,393,393,393,393,97,209,49,49,97,97,285,97,97,49,49,97,97,97,285,97,97,285,97,97,49,49,97,97,285,97,97,49,49,49,285,235,97,97,393,393,393,393,393,393,51,49,49,49],
   [49,49,143,49,49,49,97,97,393,393,393,393,393,393,308,393,393,393,393,393,393,308,393,393,393,393,393,308,393,393,393,393,393,393,393,393,308,393,393,393,393,393,393,393,393,393,393,393,393,393,393,393,393,393,393,393,393,97,209,211,97,393,308,393,97,209,49,97,393,393,308,393,393,308,393,97,209,211,97,393,308,393,97,209,211,97,308,393,97,393,393,393,393,393,393,393,51,49,49,49],
   [49,49,49,49,49,97,393,393,393,393,393,410,393,393,331,393,393,393,393,393,393,331,393,393,393,393,410,331,393,393,393,393,393,393,393,393,331,393,393,393,393,393,410,410,393,393,393,393,393,393,393,393,393,97,393,393,393,393,97,97,393,393,331,393,97,97,97,97,393,393,331,393,393,331,393,231,97,97,235,393,331,393,231,97,97,235,331,393,53,393,393,393,393,393,393,393,51,49,49,49],
   [49,49,49,49,97,412,393,393,393,393,410,410,393,393,393,393,393,408,410,393,393,393,393,393,393,393,410,410,393,393,393,393,393,393,393,393,393,393,393,393,393,393,408,410,393,393,393,393,393,393,393,393,393,393,393,393,393,393,393,393,393,393,393,393,393,393,393,393,393,393,393,393,393,393,393,393,393,393,393,393,393,393,393,393,393,393,393,393,97,393,393,393,393,393,393,97,57,49,49,49],
   [49,438,49,285,412,393,393,393,393,410,410,410,408,393,393,393,393,393,393,393,393,393,393,393,393,410,408,408,393,393,393,393,393,393,393,393,393,393,393,393,393,393,393,393,393,393,393,393,393,393,393,393,393,393,393,393,393,393,393,393,393,393,393,393,393,393,393,393,410,393,393,393,393,393,393,393,393,393,393,393,393,393,393,393,393,393,393,393,97,97,393,393,393,393,393,393,51,49,49,49],
   [438,438,97,308,412,393,393,410,393,410,410,408,393,393,393,393,393,393,393,393,393,393,393,393,393,393,393,393,393,393,393,393,393,393,393,393,393,393,393,393,393,393,393,393,393,393,393,393,393,393,393,393,393,393,393,393,393,393,393,393,393,393,393,393,393,393,393,393,393,393,408,393,393,393,393,393,393,393,393,393,393,408,393,410,393,393,393,393,412,393,393,393,393,393,393,393,51,49,49,49],
   [51,97,393,331,412,393,393,393,393,393,393,393,393,393,454,393,393,393,393,393,393,393,393,393,393,393,393,454,393,393,408,393,393,393,393,393,393,393,454,393,393,393,393,393,393,393,393,393,97,97,393,393,454,393,393,393,393,393,408,408,393,97,97,97,393,454,393,393,393,393,97,97,97,393,393,393,393,454,393,97,97,97,393,393,393,393,393,393,454,393,393,393,393,393,393,393,51,49,49,49],
   [363,393,393,393,412,393,393,393,393,393,393,393,393,393,393,393,393,393,393,393,393,393,393,393,393,393,393,393,393,393,393,393,393,393,393,393,393,393,393,393,408,410,410,393,393,393,393,393,393,393,393,393,393,393,393,393,393,393,393,393,393,393,393,393,393,393,393,393,393,393,393,393,393,393,393,393,393,393,393,393,393,393,393,393,393,393,393,393,412,393,393,393,393,393,393,393,57,49,49,49],
   [363,393,393,393,393,393,393,393,393,393,393,393,393,393,393,393,393,393,393,359,360,393,393,393,393,393,393,393,393,393,393,393,359,360,393,393,393,393,393,393,410,410,393,393,393,359,360,393,393,393,410,393,393,393,393,393,393,393,393,359,360,393,393,393,393,393,393,393,393,393,393,359,360,393,393,393,393,393,393,393,393,393,393,393,359,360,393,393,393,393,393,393,393,393,393,97,51,49,49,49],
   [363,393,393,393,393,393,393,393,393,393,393,393,393,393,393,393,393,393,393,382,383,393,393,393,393,393,393,393,393,393,393,393,382,383,393,393,393,393,393,393,393,393,393,393,393,382,383,393,393,393,393,393,393,393,393,393,393,393,393,382,383,393,393,393,393,393,393,393,393,393,393,382,383,393,393,393,393,393,393,393,393,393,393,393,382,383,393,393,393,393,393,393,393,393,393,393,51,438,438,49],
   [363,393,393,393,393,393,393,393,393,393,393,393,393,393,393,393,393,393,393,405,406,393,393,393,393,393,393,393,393,393,393,393,405,406,393,393,393,393,393,393,393,393,393,393,393,405,406,393,393,393,393,393,393,393,393,393,393,393,393,405,406,393,393,393,393,393,393,393,393,393,393,405,406,393,393,393,393,393,393,393,393,393,393,393,405,406,393,393,393,393,393,393,393,393,393,393,51,438,438,49],
   [51,51,51,51,51,51,51,51,51,51,51,51,51,51,51,51,51,51,51,51,51,51,51,51,51,51,51,51,51,51,51,51,51,51,51,51,51,51,51,51,51,51,51,51,51,51,51,51,51,51,51,51,51,51,51,51,51,51,51,51,51,51,51,51,51,51,51,51,51,51,51,51,51,51,51,51,51,51,51,51,51,51,51,51,51,51,51,51,51,51,51,51,51,51,51,51,51,440,441,440],
   [438,438,438,49,49,49,49,49,49,49,49,49,49,49,49,49,49,49,49,49,49,49,49,49,49,49,49,49,49,49,49,49,49,49,49,49,49,49,49,49,49,49,49,49,49,49,49,49,49,49,49,49,49,49,49,49,49,49,49,49,49,49,49,49,49,49,49,49,49,49,49,49,49,49,49,49,49,49,49,49,49,49,49,49,49,49,49,49,49,49,49,49,49,49,49,438,438,463,464,463],
   [438,438,49,49,49,49,49,49,49,49,49,143,49,49,49,49,49,49,49,49,49,49,49,49,49,49,49,49,49,49,49,49,49,49,49,49,49,49,49,49,49,49,49,49,49,49,49,49,49,49,49,49,49,49,49,49,49,49,49,49,49,49,49,49,49,49,49,49,49,49,49,49,49,49,49,49,49,49,49,49,49,49,49,49,49,49,49,49,49,49,49,49,49,49,49,49,438,440,441,440],
   [49,49,49,49,49,49,49,49,49,49,49,49,49,49,49,49,49,49,49,49,145,49,49,49,49,49,49,49,49,49,49,49,49,49,49,49,49,49,49,49,49,49,49,49,49,49,49,49,49,49,49,49,49,49,49,49,49,49,49,49,49,49,49,49,49,49,49,49,49,49,49,49,49,49,49,49,49,49,49,49,49,49,49,49,49,49,49,49,49,49,49,49,49,49,49,49,49,463,464,463],
   [49,49,49,49,49,49,49,49,145,49,49,49,49,49,49,49,49,49,49,49,49,49,49,49,49,49,49,49,49,49,49,49,49,49,49,49,49,49,49,49,49,49,49,49,49,49,49,49,49,49,49,49,49,49,49,49,49,49,49,49,49,49,49,49,49,49,49,49,49,49,49,49,49,49,49,49,49,49,49,49,49,49,49,49,49,49,49,49,49,49,49,49,49,49,49,49,49,49,49,49],
   [49,49,49,49,49,49,49,49,49,49,49,49,49,49,49,49,49,49,49,49,49,49,49,49,49,49,49,49,49,49,49,49,49,49,49,49,49,49,49,49,49,49,49,145,49,49,49,49,49,49,145,49,49,49,49,49,49,49,49,143,49,49,49,49,49,49,49,49,49,49,49,49,49,49,49,49,49,49,49,49,49,49,49,49,49,49,49,49,49,49,49,49,49,49,49,49,49,49,49,49],
   [49,49,145,49,49,49,49,49,49,49,49,49,49,49,49,49,49,49,49,49,49,49,49,49,49,49,49,49,143,49,49,49,49,49,49,49,49,49,49,49,49,49,49,49,49,49,49,49,49,49,49,49,49,49,49,49,49,49,49,49,49,49,49,49,49,49,49,49,49,49,49,49,49,49,49,49,49,49,49,49,49,49,49,49,49,49,49,49,49,49,49,49,49,49,49,49,49,49,49,49],
   [49,49,49,49,49,49,49,49,49,49,49,49,49,49,49,49,49,49,49,49,49,49,49,49,49,49,49,49,49,49,49,49,49,49,49,49,49,49,143,49,49,49,49,49,49,49,49,49,49,49,49,49,49,49,49,49,49,49,49,49,49,49,49,49,49,49,49,49,49,49,49,49,49,49,49,49,49,49,49,49,49,49,49,49,49,49,49,49,49,49,49,49,49,49,49,49,49,49,49,49],
   [49,49,49,49,49,49,49,49,49,49,49,49,49,49,49,49,145,49,49,49,49,49,49,49,49,49,49,49,49,49,49,49,49,49,49,49,49,49,49,49,49,49,49,49,49,49,49,49,49,49,49,49,49,49,49,49,49,49,49,49,49,49,49,49,49,49,49,49,49,49,49,49,49,49,49,49,49,49,49,49,49,49,49,49,49,49,49,49,49,49,49,49,49,49,49,49,49,49,49,49],
   [49,49,49,49,145,49,49,49,49,49,49,49,49,49,49,49,49,49,49,49,49,49,49,49,49,49,49,49,49,49,49,49,49,49,49,49,49,49,49,49,49,49,49,49,49,49,49,49,49,49,49,49,49,49,49,49,49,49,49,49,49,145,49,49,49,49,49,49,49,49,49,49,49,49,49,49,49,49,49,49,49,49,49,49,49,49,49,49,49,49,49,49,49,49,49,49,49,49,49,49],
   [49,49,49,49,49,49,49,49,49,49,49,49,49,49,49,49,49,49,49,49,49,49,49,49,49,49,49,49,49,49,49,49,145,49,49,49,49,49,49,49,49,49,49,49,49,49,49,49,49,49,49,49,49,49,49,49,49,49,49,49,49,49,49,49,49,49,49,49,49,49,49,49,49,49,49,49,49,49,49,49,49,49,49,49,49,49,49,49,49,49,49,49,49,49,49,49,49,49,49,49],
   [49,49,49,49,49,49,49,49,49,49,49,49,49,49,49,49,49,49,49,49,49,49,49,49,49,49,49,49,49,49,49,49,49,49,49,49,49,49,49,49,49,49,49,49,49,49,49,49,49,49,49,49,49,49,49,49,49,49,49,49,49,49,49,49,49,49,49,49,49,49,49,49,49,49,49,49,49,49,49,49,49,49,49,49,49,49,49,49,49,49,49,49,49,49,49,49,49,49,49,49],
   [49,49,49,49,49,49,49,49,49,49,49,49,49,49,49,49,49,49,49,49,49,49,49,49,49,49,49,49,49,49,49,49,49,49,49,49,49,49,49,49,49,49,49,49,49,49,49,49,145,49,49,49,49,49,49,49,49,49,49,49,49,49,49,49,49,49,49,49,49,49,49,49,49,49,49,49,49,49,49,49,49,49,49,49,49,49,49,49,49,49,49,49,49,49,49,49,49,49,49,49],
   [49,49,49,49,49,49,49,49,49,49,49,49,49,49,49,49,49,49,49,49,49,49,49,49,49,49,49,49,49,49,49,49,49,49,49,49,49,49,49,49,49,49,49,49,49,49,49,49,49,145,49,49,49,49,49,49,49,49,49,49,49,49,49,49,49,49,49,49,49,49,49,49,49,49,49,49,49,49,49,49,49,49,49,49,49,49,49,49,49,49,49,49,49,49,49,49,49,49,49,49]
]
